........@.....
......@.......
......@.......
....@.........
.....@........
.......@......
........@.....
........@.....
.........@....
..........@...