......@......
.......@......
.....@........
.....@........
...@@.........
.....@........
......@$......
........@.....
......@.......
.....@@.......
...@..........
.....@........
......@@......
........@.....
........@.....
.........@$...
........@.....
.......@......
.......@......
.....@@.......
.......$......
........@@....
..........@...
...........@..
..........@...
..........$...
.........@@...
.........@....
........@.....
.......F......