....@@.........
.....@........
......@.......
.......@$.....
.........@....
........@.....
.......@......
.....@@.......
...@..........
....@.........
.....$........
....@.........
......@.......
.....@........
.......@......
......@.......
.......@......
.........@....
.......@......
......@.......
.....@........
......@.......
.......@......
......@.......
.......@......
......@.......
......@@@.....
.........@....
.........@....
.......F......