....@.........
...@..........
.....@........
.......@@.....
......@.......
.......@......
........@.....
.........@....
.......$@.....
.......@......
......@.......
.....@........
......@@@.....
........@$....
.........@....
..........@...
.......@@@....
......@.......
....$.........
.....@........
......@.......
.......@@.....
.........@....
.........@....
..........@$..
.........@....
........@.....
......@.......
.......@......
......F.......