..@@@...........
....@.........
.....@$........
.......@......
......$.......
....$.........
.....@........
......@.......
.......@$.....
.........@....
........@......
......@.......
.......@$.....
......@.......
.......@......
........@.....
......@@......
.....@........
...$$..........
..@...........
...@$..........
.....@........
.....@........
......@$.......
........@.....
.......@......
......@.......
.......@$......
.........@@...
.......F......