....@.........
....@.........
.....@$.......
.......@......
........@.....
.......@......
......@.......
....$@........
...@..........
....@.........
.....@........
......@.......
....@@........
...$..........
....@.........
.....@........
......@@@.....
........@.....
.......@......
......@$......
.....@........
....@........
...@..........
....@.........
.....@........
......@@......
........@.....
.......@......
....@@$.......
.F............