........@.....
.......@......
......@.......
....@$........
...@..........
....@@@.......
.......@......
.......@......
......@.......
......@.......
....@@........
.....@........
......@.......
.......$@.....
........@.....
.........@....
.........@@...
.........@....
........@.....
......@@......
......@.......
.......@@@....
.......@......
.....@@.......
....@.........
...$..........
....@@@.......
........@.....
........@.....
.......F......