.@............
..@$...........
....$.........
..@...........
...@..........
.....@$........
.......@......
......@.......
....@.........
.....@........
......@.......
.......@$......
..........@...
.........@....
.......$......
.....@........
....@.........
...@..........
....@.........
.....@........
......@.......
.......$......
........@.....
.......@......
......$$.......
........@.....
.........@....
........@.....
......@.......
....F.........