........@.....
.......@......
.....@........
.....@........
...@..........
.....@........
.......$......
........@.....
......@.......
.....@@.......
....@.........
.....@........
.......@......
........@.....
........@.....
.........@$...
........@.....
.......@......
.......@......
.....@........
.......$......
........@@....
..........@...
...........@..
..........@...
..........$...
.........@@...
.........@....
.......F......