........@.....
.......@......
......@.......
....@@........
...@..........
....@@@.......
.......@......
.......@......
......@.......
......@.......
....@@........
.....@........
......@.......
.......@@.....
........@.....
.........@....
..........@...
.........@....
........@.....
......@@......
......@.......
........@@....
.......@......
.....@@.......
....@.........
...@..........
....@@@.......
........@.....
........@.....
.......F......