........@.....
.......@......
.....@........
.....@........
...@..........
.....@........
.......@......
........@.....
......@.......
.....@@.......
....@.........
.....@........
.......@......
........@.....
.......F......