.........@....
.......@......
.....@........
.....@........
...@..........
.....@........
.......@......
........@.....
......@.......
......@.......
....@.........
.....@........
.......@......
........@.....
........@.....
.........@....
..........@...
.........@....
........@.....
......@.......
......@.......
.........@....
.......@......
.....@........
....@.........
...@..........
......@.......
........@.....
........@.....
.......F......