.........@@...
........@.....
.......@......
......@.......
....$@.........
....@.........
.....@........
.......@......
......@.......
....@.........
.....@@.......
.....@........
......@.......
.......@......
........@.....
.......@......
.....@........
....$.........
...@..........
....@@........
......@.......
......@.......
.......@......
........@.....
.......@......
........@.....
.......@......
........@.....
......@@......
.........F....