.....@@.......
.......@......
.....@........
......@.......
.......@......
........@.....
.......@......
.....@........
......@.......
.......@......
........@$....
.........@....
........@.....
......@.......
....$.........
.....@........
......@.......
.....@........
......@.......
.......@......
.......@.......
........@$.....
..........@...
........@.....
.......@......
.....@........
......@.......
.......@......
........@.....
..........F...